%                                                              
+                                                              
                 +                    +                        
|           %          %          %                           |
===         ============          =====  -------              |
                                                          .  D|
=  == ===========.=============   ====H==      ==H===     =====
.                                     H  =       H             
|             ---======H        .     H   =      H             
|                      H              H    =  ======           
========  =====        ==----===      H     =       =          
                     |                H              =         
      H=====-        |     ======     H               =        
      H       ========            HHHHHHHHHHH.                 
    ==H==   .  | SNP |            H                  ====      
      H     .  |     |       H====H                   |        
      H       =------        H                   -----|   =   |
      H     .     ^^         H                  |-----|  =    |
* i   H     .     ^^         H                 *| %%% |    % *|
===============================================================
